M01
20
15
3
B
R0 R0 R0 R0 R0 R0 R0 R0 R0 R0 R0 R0 R0 R0 R0 R0 R0 R0 R0 R0
R0 R0 R0 R0 R0 R0 R0 R0 R0 R0 R0 R0 R0 R0 R0 R0 R0 R0 R0 R0
R0 R0 G0 G0 G0 G0 G0 G0 G0 G0 G0 G0 G0 G0 G0 G0 G0 G0 R0 R0
R0 R0 G0 G0 G0 G0 G0 G0 G0 G0 G0 G0 G0 G0 G0 G0 G0 G0 R0 R0
R0 R0 G0 G0 G0 G0 G0 G0 G0 G0 G0 G0 G0 G0 G0 G0 G0 G0 R0 R0
R0 R0 G0 G0 G0 G0 G0 G0 G0 G0 G0 G0 G0 G0 G0 G0 G0 G0 R0 R0
R0 R0 G0 G0 G0 G0 G0 G0 G0 G0 G0 G0 G0 G0 G0 G0 G0 G0 R0 R0
R0 R0 G0 G0 G0 G0 G0 G0 G0 G0 G0 G0 G0 G0 G0 G0 G0 G0 R0 R0
R0 R0 G0 G0 G0 G0 G0 G0 G0 G0 G0 G0 G0 G0 G0 G0 G0 G0 R0 R0
R0 R0 G0 G0 G0 G0 G0 G0 G0 G0 G0 G0 G0 G0 G0 G0 G0 G0 R0 R0
R0 R0 G0 G0 G0 G0 G0 G0 G0 G0 G0 G0 G0 G0 G0 G0 G0 G0 R0 R0
R0 R0 G0 G0 G0 G0 G0 G0 G0 G0 G0 G0 G0 G0 G0 G0 G0 G0 R0 R0
R0 R0 G0 G0 G0 G0 G0 G0 G0 G0 G0 G0 G0 G0 G0 G0 G0 G0 R0 R0
R0 R0 R0 R0 R0 R0 R0 R0 R0 R0 R0 R0 R0 R0 R0 R0 R0 R0 R0 R0
R0 R0 R0 R0 R0 R0 R0 R0 R0 R0 R0 R0 R0 R0 R0 R0 R0 R0 R0 R0
O
W0 W0 W0 W0 W0 W0 W0 W0 W0 W0 W0 W0 W0 W0 W0 W0 W0 W0 W0 W0
W0 XX XX XX XX XX XX XX XX XX XX XX XX XX XX XX XX XX XX R0
W0 XX XX XX XX XX XX XX XX XX XX XX XX XX XX XX XX XX XX R0
W0 XX XX XX XX XX XX XX XX XX XX XX XX XX XX XX XX XX XX R0
W0 XX XX XX XX XX XX XX XX XX XX XX XX XX XX XX XX XX XX R0
W0 XX XX XX XX XX XX XX XX XX XX XX XX XX XX XX XX XX XX R0
W0 XX XX XX XX XX XX XX XX XX XX XX XX XX XX XX XX XX XX R0
W0 XX XX XX XX XX XX XX XX XX XX XX XX XX XX XX XX XX XX R0
W0 XX XX XX XX XX XX XX XX XX XX XX XX XX XX XX XX XX XX R0
W0 XX XX XX XX XX XX XX XX XX XX XX XX XX XX XX XX XX XX R0
W0 XX XX XX XX XX XX XX XX XX XX XX XX XX XX XX XX XX XX R0
W0 XX XX XX XX XX XX XX XX XX XX XX XX XX XX XX XX XX XX R0
W0 XX XX XX XX XX XX XX XX XX XX XX XX XX XX XX XX XX XX R0
W0 XX XX XX XX XX XX XX XX XX XX XX XX XX XX XX XX XX XX R0
W0 W0 W0 W0 W0 W0 W0 W0 W0 W0 W0 W0 W0 W0 W0 W0 W0 W0 W0 W0
C
XX XX XX XX XX XX XX XX XX XX XX XX XX XX XX XX XX XX XX XX
XX XX XX XX XX XX XX XX XX XX XX XX XX XX XX XX XX XX XX XX
XX XX XX XX XX XX XX XX XX XX XX XX XX XX XX XX XX XX XX XX
XX XX XX XX XX XX XX XX XX XX XX XX XX XX XX XX XX XX XX XX
XX XX XX XX XX XX XX XX XX XX XX XX XX XX XX XX XX XX XX XX
XX XX XX XX XX XX XX XX XX XX XX XX XX XX XX XX XX XX XX XX
XX XX XX XX XX XX XX XX XX XX XX XX XX XX XX XX XX XX XX XX
XX XX XX XX XX XX XX XX XX XX XX XX XX XX XX XX XX XX XX XX
XX XX XX XX XX XX XX XX XX XX XX XX XX XX XX XX XX XX XX XX
XX XX XX XX XX XX XX XX XX XX XX XX XX XX XX XX XX XX XX XX
XX XX XX XX XX XX XX XX XX XX XX XX XX XX XX XX XX XX XX XX
XX XX XX XX XX XX XX XX XX XX XX XX XX XX XX XX XX XX XX XX
XX XX XX XX XX XX XX XX XX XX XX XX XX XX XX XX XX XX XX XX
XX XX XX XX XX XX XX XX XX XX XX XX XX XX XX XX XX XX XX XX
XX XX XX XX XX XX XX XX XX XX XX XX XX XX XX XX XX XX XX XX

//Comments:
//Map ID
//Number of Columns
//Number of Rows
//Number of Layers
//Layer Type (B = Background, O = Object, C = Creature)
//XX = Blank Tile